cheerful	CH IH R F AH L
does	D AH Z
does(2)	D IH Z
happy	HH AE P IY
mean	M IY N
means	M IY N Z
no	N OW
not	N AA T
question	K W EH S CH AH N
question(2)	K W EH SH AH N
sad	S AE D
scratch	S K R AE CH
story	S T AO R IY
thank	TH AE NG K
that	DH AE T
that(2)	DH AH T
unhappy	AH N HH AE P IY
validate	V AE L AH D EY T
yes	Y EH S
you Y UW
